R         500 500
NO            ./textures/te.xpm
SO             ./textures/te1.xpm
WE       ./textures/te2.xpm
EA      ./textures/te3.xpm
S            ./textures/barrel.xpm
C        110     , 55      , 110
F            0    ,   0      , 0


1111111111
1000000001
1020202001
10000000W1
1000000001
1000000001
1000000001
1020202001
1000000001
1000000001
1111111111