R            500          500
NO                 ./textures/IMG_6463.xpm
SO             ./textures/IMG_6508.xpm
WE       ./textures/IMG_6840.xpm
EA      ./textures/IMG_6849.xpm
S            ./textures/barrel.xpm
C        110,     110,110
F             220  ,42 ,   234

1111111111
1000000001
1020202001
10000000S1
1000000001
1000000001
1000000001
1020202001
1000000001
1000000001
1111111111