R 1920 1080
NO ./textures/te.xpm
SO ./textures/te1.xpm
WE ./textures/te2.xpm
S ./textures/barrel.xpm
EA ./textures/te3.xpm
C 110,110,110
F 220,220,234


1111111111
1000000001
1020202001
10000000S1
1000000001
1000000001
1000000001
1020202001
1000000001
1000000001
1111111111